border_size=1
usage=map

Wwt         , Wwt         , Wwt         , Wwt         , Wwt         , Wwt         , Wwt         , Wwt         , Wwt         , Wwt         , Wwt         , Wwt         , Wwt         , Wwt         , Wwt         , Wwt         , Wwt         , Wwt         , Wwt         , Wwt         , Wwt         , Wwt         , Wwt         , Wwt         , Wwt         , Wwt         , Wwt         , Wwt         , Wwt         , Wwt         , Wwt         , Wwt         , Wwt         , Wwt         , Wwt         , Wwt         , Wwt         , Wwt         , Wwt         , Wwt         , Wwt         , Wwt         
Wwt         , Wwt         , 9 Wwt       , Wwt         , 1 Wwt       , Wwt         , 2 Wwt       , Wwt         , 3 Wwt       , Wwt         , 4 Wwt       , Wwt         , 5 Wwt       , Wwt         , 6 Wwt       , Wwt         , 7 Wwt       , Wwt         , 8 Wwt       , Wwt         , Wwt         , Wwt         , Wwt         , Wwt         , Wwt         , Wwt         , Wwt         , Wwt         , Wwt         , Wwt         , Wwt         , Wwt         , Wwt         , Wwt         , Wwt         , Wwt         , Wwt         , Wwt         , Wwt         , Wwt         , Wwt         , Wwt         
Wwt         , Wwt         , Wwt         , Wwt         , Wwt         , Wwt         , Wwt         , Wwt         , Wwt         , Wwt         , Wwt         , Wwt         , Wwt         , Wwt         , Wwt         , Wwt         , Wwt         , Wwt         , Wwt         , Wwt         , Wwt         , Wwt         , Wwt         , Wwt         , Wwt         , Wwt         , Wwt         , Wwt         , Wwt         , Wwt         , Wwt         , Wwt         , Wwt         , Wwt         , Wwt         , Wwt         , Wwt         , Wwt         , Wwt         , Wwt         , Wwt         , Wwt         
Wwt         , Wwt         , Wwt         , Wwt         , Xv          , Xv          , Xv          , Wwt         , Wwt         , Wwt         , Xv          , Xv          , Xv          , Xv          , Xv          , Xv          , Xv          , Xv          , Xv          , Xv          , Xv          , Xv          , Xv          , Wwt         , Wwt         , Wwt         , Xv          , Xv          , Xv          , Wwt         , Xv          , Xv          , Xv          , Wwt         , Wwt         , Wwt         , Xv          , Xv          , Xv          , Wwt         , Wwt         , Wwt         
Wwt         , Wwt         , Wwt         , Xv          , Wwt         , Wwt         , Wwt         , Xv          , Wwt         , Xv          , Wwt         , Wwt         , Wwt         , Wwt         , Wwt         , Xv          , Wwt         , Wwt         , Wwt         , Xv          , Wwt         , Wwt         , Xv          , Wwt         , Wwt         , Xv          , Wwt         , Wwt         , Wwt         , Xv          , Wwt         , Wwt         , Wwt         , Xv          , Wwt         , Xv          , Wwt         , Wwt         , Wwt         , Xv          , Wwt         , Wwt         
Wwt         , Wwt         , Wwt         , Xv          , Xv          , Wwt         , Wwt         , Wwt         , Wwt         , Xv          , Wwt         , Wwt         , Wwt         , Wwt         , Wwt         , Xv          , Wwt         , Wwt         , Wwt         , Xv          , Wwt         , Wwt         , Xv          , Wwt         , Wwt         , Xv          , Wwt         , Wwt         , Wwt         , Xv          , Wwt         , Wwt         , Xv          , Xv          , Wwt         , Xv          , Xv          , Wwt         , Wwt         , Wwt         , Wwt         , Wwt         
Wwt         , Wwt         , Wwt         , Wwt         , Wwt         , Xv          , Xv          , Wwt         , Wwt         , Xv          , Xv          , Xv          , Wwt         , Wwt         , Wwt         , Xv          , Wwt         , Wwt         , Wwt         , Xv          , Wwt         , Wwt         , Xv          , Wwt         , Wwt         , Xv          , Xv          , Xv          , Wwt         , Xv          , Xv          , Xv          , Xv          , Wwt         , Wwt         , Wwt         , Wwt         , Xv          , Xv          , Wwt         , Wwt         , Wwt         
Wwt         , Wwt         , Wwt         , Wwt         , Wwt         , Wwt         , Wwt         , Xv          , Wwt         , Xv          , Wwt         , Wwt         , Wwt         , Wwt         , Wwt         , Xv          , Wwt         , Wwt         , Wwt         , Xv          , Wwt         , Wwt         , Xv          , Wwt         , Wwt         , Xv          , Wwt         , Wwt         , Wwt         , Xv          , Wwt         , Wwt         , Wwt         , Xv          , Wwt         , Wwt         , Wwt         , Wwt         , Wwt         , Xv          , Wwt         , Wwt         
Wwt         , Wwt         , Wwt         , Xv          , Xv          , Wwt         , Xv          , Xv          , Wwt         , Xv          , Xv          , Wwt         , Xv          , Wwt         , Wwt         , Xv          , Wwt         , Wwt         , Wwt         , Xv          , Wwt         , Wwt         , Xv          , Wwt         , Xv          , Xv          , Xv          , Wwt         , Xv          , Xv          , Wwt         , Wwt         , Wwt         , Xv          , Wwt         , Xv          , Xv          , Wwt         , Xv          , Xv          , Wwt         , Wwt         
Wwt         , Wwt         , Wwt         , Wwt         , Wwt         , Xv          , Wwt         , Wwt         , Wwt         , Wwt         , Wwt         , Xv          , Wwt         , Wwt         , Wwt         , Xv          , Wwt         , Wwt         , Wwt         , Xv          , Wwt         , Wwt         , Wwt         , Xv          , Wwt         , Wwt         , Wwt         , Xv          , Wwt         , Xv          , Wwt         , Wwt         , Wwt         , Xv          , Wwt         , Wwt         , Wwt         , Xv          , Wwt         , Wwt         , Wwt         , Wwt         
Wwt         , Wwt         , Wwt         , Wwt         , Wwt         , Wwt         , Wwt         , Wwt         , Wwt         , Wwt         , Wwt         , Wwt         , Wwt         , Wwt         , Wwt         , Wwt         , Wwt         , Wwt         , Wwt         , Wwt         , Xv          , Xv          , Xv          , Wwt         , Wwt         , Wwt         , Wwt         , Wwt         , Wwt         , Wwt         , Wwt         , Wwt         , Wwt         , Wwt         , Wwt         , Wwt         , Wwt         , Wwt         , Wwt         , Wwt         , Wwt         , Wwt         
Wwt         , Wwt         , Wwt         , Wwt         , Wwt         , Wwt         , Wwt         , Wwt         , Wwt         , Wwt         , Wwt         , Wwt         , Wwt         , Wwt         , Wwt         , Wwt         , Xv          , Xv          , Xv          , Wwt         , Xv          , Wwt         , Wwt         , Wwt         , Wwt         , Wwt         , Wwt         , Wwt         , Wwt         , Wwt         , Wwt         , Wwt         , Wwt         , Wwt         , Wwt         , Wwt         , Wwt         , Wwt         , Wwt         , Wwt         , Wwt         , Wwt         
Wwt         , Wwt         , Wwt         , Wwt         , Wwt         , Wwt         , Wwt         , Wwt         , Wwt         , Wwt         , Wwt         , Wwt         , Wwt         , Wwt         , Wwt         , Wwt         , Xv          , Wwt         , Xv          , Wwt         , Xv          , Xv          , Wwt         , Wwt         , Wwt         , Wwt         , Wwt         , Wwt         , Wwt         , Wwt         , Wwt         , Wwt         , Wwt         , Wwt         , Wwt         , Wwt         , Wwt         , Wwt         , Wwt         , Wwt         , Wwt         , Wwt         
Wwt         , Wwt         , Wwt         , Wwt         , Wwt         , Wwt         , Wwt         , Wwt         , Wwt         , Wwt         , Wwt         , Wwt         , Wwt         , Wwt         , Wwt         , Wwt         , Wwt         , Xv          , Wwt         , Wwt         , Xv          , Wwt         , Wwt         , Wwt         , Wwt         , Wwt         , Wwt         , Wwt         , Wwt         , Wwt         , Wwt         , Wwt         , Wwt         , Wwt         , Wwt         , Wwt         , Wwt         , Wwt         , Wwt         , Wwt         , Wwt         , Wwt         
Wwt         , Wwt         , Wwt         , Xv          , Wwt         , Wwt         , Wwt         , Xv          , Wwt         , Wwt         , Xv          , Xv          , Xv          , Wwt         , Xv          , Xv          , Xv          , Wwt         , Wwt         , Xv          , Xv          , Wwt         , Wwt         , Xv          , Wwt         , Wwt         , Xv          , Xv          , Xv          , Wwt         , Xv          , Wwt         , Xv          , Wwt         , Xv          , Wwt         , Wwt         , Wwt         , Xv          , Wwt         , Wwt         , Wwt         
Wwt         , Wwt         , Wwt         , Xv          , Wwt         , Wwt         , Wwt         , Xv          , Wwt         , Xv          , Wwt         , Wwt         , Wwt         , Xv          , Wwt         , Wwt         , Wwt         , Xv          , Wwt         , Xv          , Xv          , Wwt         , Wwt         , Xv          , Wwt         , Xv          , Wwt         , Wwt         , Wwt         , Xv          , Wwt         , Xv          , Xv          , Xv          , Wwt         , Xv          , Wwt         , Wwt         , Xv          , Wwt         , Wwt         , Wwt         
Wwt         , Wwt         , Wwt         , Xv          , Wwt         , Xv          , Wwt         , Xv          , Wwt         , Xv          , Wwt         , Wwt         , Wwt         , Xv          , Xv          , Wwt         , Wwt         , Wwt         , Wwt         , Xv          , Wwt         , Xv          , Wwt         , Xv          , Wwt         , Xv          , Wwt         , Wwt         , Wwt         , Xv          , Wwt         , Wwt         , Xv          , Wwt         , Wwt         , Xv          , Wwt         , Wwt         , Xv          , Wwt         , Wwt         , Wwt         
Wwt         , Wwt         , Wwt         , Xv          , Wwt         , Xv          , Wwt         , Xv          , Wwt         , Xv          , Xv          , Xv          , Wwt         , Wwt         , Wwt         , Xv          , Xv          , Wwt         , Wwt         , Xv          , Wwt         , Xv          , Xv          , Xv          , Wwt         , Xv          , Wwt         , Wwt         , Wwt         , Xv          , Wwt         , Wwt         , Xv          , Wwt         , Wwt         , Xv          , Xv          , Xv          , Xv          , Wwt         , Wwt         , Wwt         
Wwt         , Wwt         , Wwt         , Xv          , Wwt         , Xv          , Wwt         , Xv          , Wwt         , Xv          , Wwt         , Wwt         , Wwt         , Wwt         , Wwt         , Wwt         , Wwt         , Xv          , Wwt         , Xv          , Wwt         , Wwt         , Xv          , Xv          , Wwt         , Xv          , Wwt         , Wwt         , Wwt         , Xv          , Wwt         , Wwt         , Xv          , Wwt         , Wwt         , Xv          , Wwt         , Wwt         , Xv          , Wwt         , Wwt         , Wwt         
Wwt         , Wwt         , Wwt         , Xv          , Xv          , Xv          , Xv          , Xv          , Wwt         , Xv          , Xv          , Wwt         , Xv          , Xv          , Xv          , Wwt         , Xv          , Xv          , Wwt         , Xv          , Wwt         , Wwt         , Wwt         , Xv          , Wwt         , Xv          , Xv          , Wwt         , Xv          , Xv          , Wwt         , Wwt         , Xv          , Wwt         , Wwt         , Xv          , Wwt         , Wwt         , Xv          , Wwt         , Wwt         , Wwt         
Wwt         , Wwt         , Wwt         , Wwt         , Wwt         , Wwt         , Wwt         , Wwt         , Wwt         , Wwt         , Wwt         , Xv          , Wwt         , Wwt         , Wwt         , Xv          , Wwt         , Wwt         , Wwt         , Xv          , Wwt         , Wwt         , Wwt         , Xv          , Wwt         , Wwt         , Wwt         , Xv          , Wwt         , Wwt         , Wwt         , Wwt         , Wwt         , Wwt         , Wwt         , Xv          , Wwt         , Wwt         , Wwt         , Wwt         , Wwt         , Wwt         
Wwt         , Wwt         , Wwt         , Wwt         , Wwt         , Wwt         , Wwt         , Wwt         , Wwt         , Wwt         , Wwt         , Wwt         , Wwt         , Wwt         , Wwt         , Wwt         , Wwt         , Wwt         , Wwt         , Wwt         , Wwt         , Wwt         , Wwt         , Wwt         , Wwt         , Wwt         , Wwt         , Wwt         , Wwt         , Wwt         , Wwt         , Wwt         , Wwt         , Wwt         , Wwt         , Wwt         , Wwt         , Wwt         , Wwt         , Wwt         , Wwt         , Wwt         
