border_size=1
usage=map

Wwt         , Wwt         , Wwt         , Wwt         , Wwt         , Wwt         , Wwt         , Wwt         , Wwt         , Wwt         , Wwt         , Wwt         , Wwt         , Wwt         , Wwt         , Wwt         , Wwt         , Wwt         , Wwt         , Wwt         , Wwt         , Wwt         , Wwt         , Wwt         , Wwt         , Wwt         , Wwt         , Wwt         , Wwt         , Wwt         , Wwt         , Wwt         , Wwt         , Wwt         , Wwt         , Wwt         , Wwt         , Wwt         , Wwt         , Wwt         , Wwt         , Wwt         , Wwt         , Wwt         , Wwt         , Wwt         , Wwt         , Wwt         , Wwt         , Wwt         , Wwt         , Wwt         , Wwt         , Wwt         , Wwt         , Wwt         , Wwt         , Wwt         
Wwt         , Wwt         , 9 Wwt       , Wwt         ,1 Wwt       , Wwt         , 2 Wwt       , Wwt         , 3 Wwt       , Wwt         , 4 Wwt       , Wwt         , 5 Wwt       , Wwt         , 6 Wwt       , Wwt         , 7 Wwt       , Wwt         , 8 Wwt       , Wwt         , Wwt         , Wwt         , Wwt         , Wwt         , Wwt         , Wwt         , Wwt         , Wwt         , Wwt         , Wwt         , Wwt         , Wwt         , Wwt         , Wwt         , Wwt         , Wwt         , Wwt         , Wwt         , Wwt         , Wwt         , Wwt         , Wwt         , Wwt         , Wwt         , Wwt         , Wwt         , Wwt         , Wwt         , Wwt         , Wwt         , Wwt         , Wwt         , Wwt         , Wwt         , Wwt         , Wwt         , Wwt         , Wwt         
Wwt         , Wwt         , Wwt         , Wwt         , Wwt         , Wwt         , Wwt         , Wwt         , Wwt         , Wwt         , Wwt         , Wwt         , Wwt         , Wwt         , Wwt         , Wwt         , Wwt         , Wwt         , Wwt         , Wwt         , Wwt         , Wwt         , Wwt         , Wwt         , Wwt         , Wwt         , Wwt         , Wwt         , Wwt         , Xv          , Wwt^Bw\     , Wwt         , Wwt         , Wwt         , Wwt         , Wwt         , Wwt         , Xv          , Wwt^Bw\     , Wwt         , Wwt         , Wwt         , Wwt         , Wwt         , Wwt         , Xv          , Wwt^Bw\     , Wwt         , Wwt         , Wwt         , Wwt         , Wwt         , Wwt         , Wwt         , Wwt         , Wwt         , Wwt         , Wwt         
Wwt         , Wwt         , Wwt         , Wwt         , Wwt         , Wwt         , Wwt         , Wwt         , Wwt         , Wwt         , Wwt         , Wwt         , Wwt         , Wwt         , Wwt         , Wwt         , Wwt         , Wwt         , Wwt         , Wwt         , Wwt         , Wwt         , Wwt         , Wwt         , Wwt         , Wwt         , Wwt         , Wwt         , Wwt         , Wwt^Bw|     , Rzne        , Rrc         , Rznw        , Wwt         , Rzne        , Rrc         , Rznw        , Wwt^Bw|     , Rzne        , Rrc         , Rznw        , Wwt         , Rzne        , Rrc         , Rznw        , Wwt^Bw|     , Rzne        , Rrc         , Rznw        , Wwt         , Wwt         , Wwt         , Wwt         , Wwt         , Wwt         , Wwt         , Wwt         , Wwt         
Wwt         , Wwt         , Wwt         , Wwt         , Wwt         , Wwt         , Wwt         , Wwt         , Wwt         , Wwt         , Wwt         , Wwt         , Wwt         , Wwt         , Wwt         , Wwt         , Wwt         , Wwt         , Wwt         , Wwt         , Wwt         , Wwt         , Wwt         , Wwt         , Wwt         , Wwt         , Wwt         , Wwt         , Wwt         , Rrc         , Xv          , Xv          , Xv          , Rrc         , Xv          , Xv          , Xv          , Rrc         , Xv          , Xv          , Xv          , Rrc         , Xv          , Xv          , Xv          , Rrc         , Xv          , Xv          , Xv          , Rrc         , Wwt         , Wwt         , Wwt         , Wwt         , Wwt         , Wwt         , Wwt         , Wwt         
Wwt         , Wwt         , Wwt         , Wwt         , Wwt         , Wwt         , Wwt         , Wwt         , Wwt         , Wwt         , Wwt         , Wwt         , Wwt         , Wwt         , Wwt         , Wwt         , Wwt         , Wwt         , Wwt         , Wwt         , Wwt         , Wwt         , Wwt         , Wwt         , Wwt         , Wwt         , Wwt         , Wwt         , Wwt         , Rzn         , Xv          , Xv          , Xv          , Rzn         , Xv          , Xv          , Xv          , Rzn         , Xv          , Xv          , Xv          , Rzn         , Xv          , Xv          , Xv          , Rzn         , Xv          , Xv          , Xv          , Rzn         , Wwt^Bw/     , Xv          , Wwt         , Wwt         , Wwt         , Wwt         , Wwt         , Wwt         
Wwt         , Wwt         , Xv          , Wwt         , Wwt         , Wwt         , Wwt         , Wwt         , Wwt         , Wwt         , Wwt         , Wwt         , Wwt         , Wwt         , Wwt         , Wwt         , Wwt         , Wwt         , Wwt         , Wwt         , Wwt         , Wwt         , Wwt         , Wwt         , Wwt         , Wwt         , Wwt         , Wwt         , Rzne        , Rrc         , Rznw        , Xv          , Rzne        , Rrc         , Rznw        , Xv          , Rzne        , Rrc         , Rznw        , Xv          , Rzne        , Rrc         , Rznw        , Xv          , Rzne        , Rrc         , Rznw        , Xv          , Rzne        , Rrc         , Rznw        , Wwt^Bw|     , Wwt         , Wwt         , Wwt         , Wwt         , Wwt         , Wwt         
Wwt         , Wwt         , Wwt         , Wwt         , Wwt         , Wwt         , Wwt         , Wwt         , Wwt         , Wwt         , Wwt         , Wwt         , Wwt         , Wwt         , Wwt         , Wwt         , Wwt         , Wwt         , Wwt         , Wwt         , Wwt         , Wwt         , Wwt         , Wwt         , Wwt         , Wwt         , Wwt^Bw/     , Rrc         , Xv          , Xv          , Xv          , Rrc         , Xv          , Xv          , Xv          , Rrc         , Xv          , Xv          , Xv          , Rrc         , Xv          , Xv          , Xv          , Rrc         , Xv          , Xv          , Xv          , Rrc         , Xv          , Xv          , Xv          , Rrc         , Wwt         , Wwt         , Wwt         , Wwt         , Wwt         , Wwt         
Wwt         , Wwt         , Xv          , Wwt         , Wwt         , Wwt         , Wwt         , Wwt         , Wwt         , Wwt         , Wwt         , Wwt         , Wwt         , Wwt         , Wwt         , Wwt         , Wwt         , Wwt         , Wwt         , Wwt         , Wwt         , Wwt         , Wwt         , Wwt         , Wwt         , Xv          , Wwt^Bw\     , Rzn         , Xv          , Xv          , Xv          , Rzn         , Xv          , Xv          , Xv          , Rzn         , Xv          , Xv          , Xv          , Rzn         , Xv          , Xv          , Xv          , Rzn         , Xv          , Xv          , Xv          , Rzn         , Xv          , Xv          , Xv          , Rzn         , Wwt         , Wwt         , Wwt         , Wwt         , Wwt         , Wwt         
Wwt         , Wwt         , Wwt         , Wwt         , Wwt         , Wwt         , Wwt         , Wwt         , Wwt         , Wwt         , Wwt         , Wwt         , Wwt         , Wwt         , Wwt         , Wwt         , Wwt         , Wwt         , Wwt         , Wwt         , Wwt         , Wwt         , Wwt         , Wwt         , Wwt         , Wwt         , Rzne        , Rrc         , Rznw        , Xv          , Rzne        , Rrc         , Rznw        , Xv          , Rzne        , Rrc         , Rznw        , Xv          , Rzne        , Rrc         , Rznw        , Xv          , Rzne        , Rrc         , Rznw        , Xv          , Rzne        , Rrc         , Rznw        , Xv          , Rzne        , Rrc         , Rznw        , Wwt         , Wwt         , Wwt         , Wwt         , Wwt         
Wwt         , Wwt         , Wwt         , Wwt         , Wwt         , Wwt         , Wwt         , Wwt         , Wwt         , Wwt         , Wwt         , Wwt         , Wwt         , Wwt         , Wwt         , Wwt         , Wwt         , Wwt         , Wwt         , Wwt         , Wwt         , Wwt         , Wwt         , Wwt         , Wwt         , Rrc         , Xv          , Xv          , Xv          , Rrc         , Xv          , Xv          , Xv          , Rrc         , Xv          , Xv          , Xv          , Rrc         , Xv          , Xv          , Xv          , Rrc         , Xv          , Xv          , Xv          , Rrc         , Xv          , Xv          , Xv          , Rrc         , Xv          , Xv          , Xv          , Rrc         , Wwt^Bw\     , Wwt         , Wwt         , Wwt         
Wwt         , Wwt         , Wwt         , Wwt         , Wwt         , Wwt         , Wwt         , Wwt         , Wwt         , Wwt         , Wwt         , Wwt         , Wwt         , Wwt         , Wwt         , Wwt         , Wwt         , Wwt         , Wwt         , Wwt         , Wwt         , Wwt         , Wwt         , Wwt         , Wwt         , Rzn         , Xv          , Xv          , Xv          , Rzn         , Xv          , Xv          , Xv          , Rzn         , Xv          , Xv          , Xv          , Rzn         , Xv          , Xv          , Xv          , Rzn         , Xv          , Xv          , Xv          , Rzn         , Xv          , Xv          , Xv          , Rzn         , Xv          , Xv          , Xv          , Rzn         , Wwt^Bw/     , Xv          , Wwt         , Wwt         
Wwt         , Wwt         , Wwt         , Wwt         , Wwt         , Wwt         , Wwt         , Wwt         , Wwt         , Wwt         , Wwt         , Wwt         , Wwt         , Wwt         , Wwt         , Wwt         , Wwt         , Wwt         , Wwt         , Wwt         , Wwt         , Wwt         , Wwt         , Wwt         , Rzne        , Rrc         , Rznw        , Xv          , Rzne        , Rrc         , Rznw        , Xv          , Rzne        , Rrc         , Rznw        , Xv          , Rzne        , Rrc         , Rznw        , Xv          , Rzne        , Rrc         , Rznw        , Xv          , Rzne        , Rrc         , Rznw        , Xv          , Rzne        , Rrc         , Rznw        , Xv          , Rzne        , Rrc         , Wwt         , Wwt         , Wwt         , Wwt         
Wwt         , Wwt         , Wwt         , Wwt         , Wwt         , Wwt         , Wwt         , Wwt         , Wwt         , Wwt         , Wwt         , Wwt         , Wwt         , Wwt         , Wwt         , Wwt         , Wwt         , Wwt         , Wwt         , Wwt         , Wwt         , Wwt         , Wwt^Bw/     , Rrc         , Xv          , Xv          , Xv          , Rrc         , Xv          , Xv          , Xv          , Rrc         , Xv          , Xv          , Xv          , Rrc         , Xv          , Xv          , Xv          , Rrc         , Xv          , Xv          , Xv          , Rrc         , Xv          , Xv          , Xv          , Rrc         , Xv          , Xv          , Xv          , Rrc         , Wwt         , Wwt         , Wwt         , Wwt         , Wwt         , Wwt         
Wwt         , Wwt         , Wwt         , Wwt         , Wwt         , Wwt         , Wwt         , Wwt         , Wwt         , Wwt         , Wwt         , Wwt         , Wwt         , Wwt         , Wwt         , Wwt         , Wwt         , Wwt         , Wwt         , Wwt         , Wwt         , Xv          , Wwt^Bw\     , Rzn         , Xv          , Xv          , Xv          , Rzn         , Xv          , Xv          , Xv          , Rzn         , Xv          , Xv          , Xv          , Rzn         , Xv          , Xv          , Xv          , Rzn         , Xv          , Xv          , Xv          , Rzn         , Xv          , Xv          , Xv          , Rzn         , Xv          , Xv          , Xv          , Rzn         , Wwt         , Wwt         , Wwt         , Wwt         , Wwt         , Wwt         
Wwt         , Wwt         , Wwt         , Wwt         , Wwt         , Wwt         , Wwt         , Wwt         , Wwt         , Wwt         , Wwt         , Wwt         , Wwt         , Wwt         , Wwt         , Wwt         , Wwt         , Wwt         , Wwt         , Wwt         , Wwt         , Wwt         , Wwt         , Rrc         , Rznw        , Xv          , Rzne        , Rrc         , Rznw        , Xv          , Rzne        , Rrc         , Rznw        , Xv          , Rzne        , Rrc         , Rznw        , Xv          , Rzne        , Rrc         , Rznw        , Xv          , Rzne        , Rrc         , Rznw        , Xv          , Rzne        , Rrc         , Rznw        , Xv          , Rzne        , Rrc         , Wwt         , Wwt         , Wwt         , Wwt         , Wwt         , Wwt         
Wwt         , Wwt         , Wwt         , Wwt         , Wwt         , Wwt         , Wwt         , Wwt         , Wwt         , Wwt         , Wwt         , Wwt         , Wwt         , Wwt         , Wwt         , Wwt         , Wwt         , Wwt         , Wwt         , Wwt         , Wwt         , Wwt         , Wwt         , Wwt         , Wwt         , Rrc         , Xv          , Xv          , Xv          , Rrc         , Xv          , Xv          , Xv          , Rrc         , Xv          , Xv          , Xv          , Rrc         , Xv          , Xv          , Xv          , Rrc         , Xv          , Xv          , Xv          , Rrc         , Xv          , Xv          , Xv          , Rrc         , Wwt^Bw\     , Wwt         , Wwt         , Wwt         , Wwt         , Wwt         , Wwt         , Wwt         
Wwt         , Wwt         , Wwt         , Wwt         , Wwt         , Wwt         , Wwt         , Wwt         , Wwt         , Wwt         , Wwt         , Wwt         , Wwt         , Wwt         , Wwt         , Wwt         , Wwt         , Wwt         , Wwt         , Wwt         , Wwt         , Wwt         , Wwt         , Wwt         , Wwt         , Rzn         , Xv          , Xv          , Xv          , Rzn         , Xv          , Xv          , Xv          , Rzn         , Xv          , Xv          , Xv          , Rzn         , Xv          , Xv          , Xv          , Rzn         , Xv          , Xv          , Xv          , Rzn         , Xv          , Xv          , Xv          , Rzn         , Wwt^Bw/     , Xv          , Wwt         , Wwt         , Wwt         , Wwt         , Wwt         , Wwt         
Wwt         , Wwt         , Wwt         , Wwt         , Wwt         , Wwt         , Wwt         , Wwt         , Wwt         , Wwt         , Wwt         , Wwt         , Wwt         , Wwt         , Wwt         , Wwt         , Wwt         , Wwt         , Wwt         , Wwt         , Wwt         , Wwt         , Wwt         , Wwt         , Wwt         , Rrc         , Rznw        , Xv          , Rzne        , Rrc         , Rznw        , Xv          , Rzne        , Rrc         , Rznw        , Xv          , Rzne        , Rrc         , Rznw        , Xv          , Rzne        , Rrc         , Rznw        , Xv          , Rzne        , Rrc         , Rznw        , Xv          , Rzne        , Rrc         , Wwt         , Wwt         , Wwt         , Wwt         , Wwt         , Wwt         , Wwt         , Wwt         
Wwt         , Wwt         , Wwt         , Wwt         , Wwt         , Wwt         , Wwt         , Wwt         , Wwt         , Wwt         , Wwt         , Wwt         , Wwt         , Wwt         , Wwt         , Wwt         , Wwt         , Wwt         , Wwt         , Wwt         , Wwt         , Wwt         , Wwt         , Wwt         , Wwt         , Wwt^Bw|     , Wwt^Bw/     , Rrc         , Xv          , Xv          , Xv          , Rrc         , Xv          , Xv          , Xv          , Rrc         , Xv          , Xv          , Xv          , Rrc         , Xv          , Xv          , Xv          , Rrc         , Xv          , Xv          , Xv          , Rrc         , Wwt         , Wwt         , Wwt         , Wwt         , Wwt         , Wwt         , Wwt         , Wwt         , Wwt         , Wwt         
Wwt         , Wwt         , Wwt         , Wwt         , Wwt         , Wwt         , Wwt         , Wwt         , Wwt         , Wwt         , Wwt         , Wwt         , Wwt         , Wwt         , Wwt         , Wwt         , Wwt         , Wwt         , Wwt         , Wwt         , Wwt         , Wwt         , Wwt         , Wwt         , Wwt         , Xv          , Wwt         , Rzn         , Xv          , Xv          , Xv          , Rzn         , Xv          , Xv          , Xv          , Rzn         , Xv          , Xv          , Xv          , Rzn         , Xv          , Xv          , Xv          , Rzn         , Xv          , Xv          , Xv          , Rzn         , Wwt         , Wwt         , Wwt         , Wwt         , Wwt         , Wwt         , Wwt         , Wwt         , Wwt         , Wwt         
Wwt         , Wwt         , Wwt         , Wwt         , Wwt         , Wwt         , Wwt         , Wwt         , Wwt         , Wwt         , Wwt         , Wwt         , Wwt         , Wwt         , Wwt         , Wwt         , Wwt         , Wwt         , Wwt         , Wwt         , Wwt         , Wwt         , Wwt         , Wwt         , Wwt         , Wwt         , Wwt         , Rrc         , Rznw        , Xv          , Rzne        , Rrc         , Rznw        , Xv          , Rzne        , Rrc         , Rznw        , Xv          , Rzne        , Rrc         , Rznw        , Xv          , Rzne        , Rrc         , Rznw        , Xv          , Rzne        , Rrc         , Wwt         , Wwt         , Wwt         , Wwt         , Wwt         , Wwt         , Wwt         , Wwt         , Wwt         , Wwt         
Wwt         , Wwt         , Wwt         , Wwt         , Wwt         , Wwt         , Wwt         , Wwt         , Wwt         , Wwt         , Wwt         , Wwt         , Wwt         , Wwt         , Wwt         , Wwt         , Wwt         , Wwt         , Wwt         , Wwt         , Wwt         , Wwt         , Wwt         , Wwt         , Wwt         , Wwt         , Wwt         , Wwt         , Wwt         , Rrc         , Wwt         , Wwt^Bw|     , Wwt^Bw/     , Rrc         , Wwt         , Wwt         , Wwt         , Rrc         , Wwt^Bw\     , Wwt^Bw|     , Wwt         , Rrc         , Wwt         , Wwt         , Wwt         , Rrc         , Wwt^Bw\     , Wwt^Bw|     , Wwt         , Wwt         , Wwt         , Wwt         , Wwt         , Wwt         , Wwt         , Wwt         , Wwt         , Wwt         
Wwt         , Wwt         , Wwt         , Wwt         , Wwt         , Wwt         , Wwt         , Wwt         , Wwt         , Wwt         , Wwt         , Wwt         , Wwt         , Wwt         , Wwt         , Wwt         , Wwt         , Wwt         , Wwt         , Wwt         , Wwt         , Wwt         , Wwt         , Wwt         , Wwt         , Wwt         , Wwt         , Wwt         , Wwt         , Wwt         , Wwt         , Xv          , Wwt         , Wwt         , Wwt         , Wwt         , Wwt         , Wwt         , Wwt         , Xv          , Wwt         , Wwt         , Wwt         , Wwt         , Wwt         , Wwt         , Wwt         , Xv          , Wwt         , Wwt         , Wwt         , Wwt         , Wwt         , Wwt         , Wwt         , Wwt         , Wwt         , Wwt         
Wwt         , Wwt         , Wwt         , Wwt         , Wwt         , Wwt         , Wwt         , Wwt         , Wwt         , Wwt         , Wwt         , Wwt         , Wwt         , Wwt         , Wwt         , Wwt         , Wwt         , Wwt         , Wwt         , Wwt         , Wwt         , Wwt         , Wwt         , Wwt         , Wwt         , Wwt         , Wwt         , Wwt         , Wwt         , Wwt         , Wwt         , Wwt         , Wwt         , Wwt         , Wwt         , Wwt         , Wwt         , Wwt         , Wwt         , Wwt         , Wwt         , Wwt         , Wwt         , Wwt         , Wwt         , Wwt         , Wwt         , Wwt         , Wwt         , Wwt         , Wwt         , Wwt         , Wwt         , Wwt         , Wwt         , Wwt         , Wwt         , Wwt         
Wwt         , Wwt         , Wwt         , Wwt         , Wwt         , Wwt         , Wwt         , Wwt         , Wwt         , Wwt         , Wwt         , Wwt         , Wwt         , Wwt         , Wwt         , Wwt         , Wwt         , Wwt         , Wwt         , Wwt         , Wwt         , Wwt         , Wwt         , Wwt         , Wwt         , Wwt         , Wwt         , Wwt         , Wwt         , Wwt         , Wwt         , Wwt         , Wwt         , Wwt         , Wwt         , Wwt         , Wwt         , Wwt         , Wwt         , Wwt         , Wwt         , Wwt         , Wwt         , Wwt         , Wwt         , Wwt         , Wwt         , Wwt         , Wwt         , Wwt         , Wwt         , Wwt         , Wwt         , Wwt         , Wwt         , Wwt         , Wwt         , Wwt         
